D.melanogaster	melanogaster subgroup
D.sechellia	melanogaster subgroup
D.mauritiana	melanogaster subgroup
D.simulans	melanogaster subgroup
D.erecta	melanogaster subgroup
D.yakuba	melanogaster subgroup
D.teissieri.2733	melanogaster subgroup
D.eugracilis	melanogaster group
D.takahashii	melanogaster group
D.biarmipes	melanogaster group
D.subpulchrella.L1	melanogaster group
D.elegans	melanogaster group
D.fuyamai	melanogaster group
D.kurseongensis	melanogaster group
D.carrolli	melanogaster group
D.rhopaloa	melanogaster group
D.ficusphila	melanogaster group
D.oshimai	melanogaster group
D.rufa	montium subgroup
D.triauraria	montium subgroup
D.kikkawai	montium subgroup
D.jambulina	montium subgroup
D.bocqueti	montium subgroup
D.spaffchauvacae	montium subgroup
D.ananassae	ananassae subgroup
D.p.nigrens	ananassae subgroup
D.p.pseudoananassae	ananassae subgroup
D.m.malerkotliana	ananassae subgroup
D.m.pallens	ananassae subgroup
D.bipectinata	ananassae subgroup
D.parabipectinata	ananassae subgroup
D.ercepeae	ananassae subgroup
D.varians	ananassae subgroup
D.persimilis	obscura group
D.pseudoobscura	obscura group
D.subobscura	obscura group
D.obscura	obscura group
D.ambigua	obscura group
D.tristis	obscura group
D.sturtevanti	saltans group
D.neocordata	saltans group
D.prosaltans	saltans group
D.saltans	saltans group
D.nebulosa	willistoni group
D.sucinea	willistoni group
D.insularis	willistoni group
D.tropicalis	willistoni group
D.willistoni.17	willistoni group
D.equinoxialis	willistoni group
D.paulistorum.L12	willistoni group
L.mommai	Lordiphosa genus
L.collinella	Lordiphosa genus
L.magnipectinata	Lordiphosa genus
L.clarofinis	Lordiphosa genus
L.stackelbergi	Lordiphosa genus
Z.lachaisei	Zaprionus genus
Z.camerounensis	Zaprionus genus
Z.nigranus	Zaprionus genus
Z.vittiger	Zaprionus genus
Z.capensis	Zaprionus genus
Z.davidi	Zaprionus genus
Z.taronus	Zaprionus genus
Z.africanus	Zaprionus genus
Z.indianus.BS02	Zaprionus genus
Z.gabonicus	Zaprionus genus
Z.ornatus	Zaprionus genus
Z.ghesquierei	Zaprionus genus
Z.inermis	Zaprionus genus
Z.kolodkinae	Zaprionus genus
Z.tsacasi	Zaprionus genus
D.quadrilineata	Drosophila subgenus
D.pruinosa	Drosophila subgenus
D.immigrans.kari17	Drosophila subgenus
D.cardini	Drosophila subgenus
D.arawakana	Drosophila subgenus
D.dunni	Drosophila subgenus
D.funebris	Drosophila subgenus
D.sp.mushsaotome	Drosophila subgenus
D.repletoides	Drosophila subgenus
D.grimshawi	Hawaiiian Drosophila
D.murphyi	Hawaiiian Drosophila
D.sproati	Hawaiiian Drosophila
S.hsui	Scaptomyza genus
S.pallida	Scaptomyza genus
S.graminum	Scaptomyza genus
S.montana	Scaptomyza genus
D.americana	Drosophila genus
D.virilis	Drosophila genus
D.ezoana	Drosophila genus
D.littoralis	Drosophila genus
D.mojavensis	Drosophila genus
D.repleta	Drosophila genus
C.costata	Chymomyza genus
L.varia	Leucophenga